OOOOOOOOOOOOOOOOOOOOOOOOOOOOOOOOOOOOOOOOOOOOO
OOOOOOOOOOOOOOOOOOOOOOOOOOOOOOOOOOOOOOOOOOOOO
OOOTTTTTTTOOOOOOOOOOOOOOOOOOOOOOOOOOOOOOOOOOO
OOOTOOOOOTOOOOOOOOOOOOOOOOOOOOOOOOOOOOOOOOOOO
OOOTOTTTTTOOOOOOOOOOOOOOOOOOTOOOOTOOOOOOOOOOO
OOOOOOOOOTOOOOOOOOOOOOOOOOOOTOOOOOOOOTOOOOOOO
OOOOOOOOOTOOOOTTTOOOOOOOOOOOOTTTTTTTTOOOOOOOO
OOOOOTOOOOOOOTOOTOTOOOOOOOOOOOOOOOOOOOOOOOOOO
OOOOTTTOOOOOTTOOOOTOOOOTTTOOOOOOOTOTOOOOOOOOO
TTTTTTTTTTTTTTTTTTTTTTTTTTTTTTTTTTTTTTTTTTTTT