OOOOOOOOOOOOOOOOOOOOOOOOOOOOOOOOOOOOOOOOOOOOO
OOOOOOOOOOOOOOOOOOOOOOOOOOOOOOOOOOOOOOOOOOOOO
OOOOOOOOOOOOOOOOOOOOOOOOOOOOOOOOOOOOOOOOOOOOO
OOOOOOOOOOOOOOOTTOOOOOOOOOOOOOOOOOOOOOOOOOOOO
OOOOOOOOTTOOOOTTTOOOOOOOOOOOOOOOOOOOOOOOOOOOO
OOOOOOOTTTOOOOTTOOOOOOOOOOOOOOOOOOOOOOOOOOOOO
OOOOTTTTTTOOOOTOOOOOOOOOOOOOOOOOOOOOOOOOOOOOO
TTTTTTTTTTOOTTTTTTTTTTTTTTTTTTTTTTTTTTTTTTTTT
TTTTTTTTTTTTTTTTTTTTTTTTTTTTTTTTTTTTTTTTTTTTT
TTTTTTTTTTTTTTTTTTTTTTTTTTTTTTTTTTTTTTTTTTTTT